........................
........................
........................
........#+#.............
........|.|.............
........|.|.............
........|.|.............
........|.|.............
#########.##############
........................
............######......
............|....|......
............|....+......
............|....|......
#############....#######
........................
........................
........................
